{
	"name": "Gems",
	"author": "Johan Dahlberg",
	"recommended_players": 8,
	
	"rules": {
	  "powerup_max": 2
	},
		
	"data": [
		[51,  0,  0,  0, 51,  0,  0,  0, 51],
		[ 0,  0,  0,  0,  0,  0,  0,  0,  0],
		[ 0, 11, 12, 11,  0, 11, 12, 11,  0],
		[51, 11, 52, 11,  0, 11, 52, 11, 51],
		[ 0, 11, 12, 11,  0, 11, 12, 11,  0],
		[ 0,  0,  0,  0,  0,  0,  0,  0,  0],
		[51,  0,  0,  0, 51,  0,  0,  0, 51]
	]
}